2,1,1,1,1,1,1,1,3
5,0,0,8,0,8,0,0,4
5,0,0,0,9,8,8,0,4
5,0,0,9,9,0,9,0,4
5,8,8,9,8,0,9,0,4
5,0,8,9,8,0,9,0,4
5,0,9,9,8,0,0,0,4
5,0,0,0,0,0,0,0,4
6,7,7,7,7,7,7,7,6